//X = Wall, # = Path, S = Start, E = End, G = Guard, - or | = Door, P = key
XXXXXXXXXXXXXXXXXXXXXXXXXXXX
XS########XXXXXXXXXXXXXXXXXX
XXXXXXXXX#XXXX############XX
XXXXX#####XXXX##XXXXXXXXX#XX
XXXXX#XXXXXXXXX#XXXXXXXXX#XX
XXXXX#XX########XXXXXXXXX#XX
XXXXX#XX#XXXXXXXXXXXXXXXXEXX
XXXXX####XXXXXXXXXXXXXXXXXXX
XXXXXXXXXXXXXXXXXXXXXXXXXXXX
XXXXXXXXXXXXXXXXXXXXXXXXXXXX
